SO                                         ./asset/Water_1.xpm

WE              	      	               ./asset/Water_6.xpm

EA ./asset/Water_11.xpm



NO ./asset/Water_10.xpm		
C -0,+0000000159,255		
F 24,100,171				

1	1	1
110111
111111