

SO                     ./asset/bluestone.xpm
WE                     ./asset/colorstone.xpm
EA  ./asset/eagle.xpm

NO  ./asset/redbrick.xpm
C   128,127,255
F   200,100,157


 111111111111111111111111111111111111
 100000000000000000000000000000000001
 100000000000000000000000000000000001
 100000000000000000000000000000000001
 1000000000G0000000001000000000000001
 100000000000000010000000000000000001
 100000000S00010000000000000000000001
 10000000001110000100000000000000001
 1000000000110000000000000000000001
 10000000001110000000000000 000000001
 100000000000000000000000000000000001
 1111111111111111111110000000000000011111111111111111
 		100000000001000111111111111111111111111111111111111
 		100000000001000111111111111111111111111111111111111
 		100000000001000111111111111111111111111111111111111
 		100000000001000111111111111111111111111111111111111
 11111111111111111111111111111111111111
 111111111111111111111111111111111111

