

SO ./asset/redbrick.xpm
WE  ./asset/colorstone.xpm
EA  ./asset/eagle.xpm

NO  ./asset/bluestone.xpm
C   128,127,255
F   200,100,157


111111111111111111111111111111111111
 100000000000000000000000000000000001
 100000000000000000000000000000000001
 100000000000000000000000000000000001
 100000000000000000001000000000000001
 100000000100000010000000000000000001
 100000000000010000000000000000000001
 100000100E0110000100000000000000001
 10000000001100000000000000000000001
 100000000111100000000000001000000001
 100000000000000000000000000000000001
 1111111111111111111110000000000000011111111111111111
 100000000001000111111111111111111111111111111111111
 100000000001000111111111111111111111111111111111111
 100000000001000111111111111111111111111111111111111
 100000000001000111111111111111111111111111111111111
 11111111111111111111111111111111111111
 111111111111111111111111111111111111

