SO                                            ./asset/bluestone.xpm

WE                                        ./asset/colorstone.xpm

EA  ./asset/eagle.xpm





NO  ./asset/redbrick.xpm
C   0,0,0
F   24,100,171


111111111111111111111111111111111111
100000000000000000000000000000000001
100000000000000000000010000000000001
100000000000000000000000000000000001
100000000000000000100000000000000001
100000000000001000000000000000000001
1000000000000000000000W0000000000001
100000000000000000000000000000000001
100000000000000000000000000000000001
100000000000000000000000000000000001
100000000000000000000000000000000001
1111111111111111111110000000000000011111111111111111
                    100000000001000111111111111111111111111111111111111
                    100000000001000111111111111111111111111111111111111
                    100000000001000111111111111111111111111111111111111
                    100000000001000111111111111111111111111111111111111
11111111111111111111111111111111111111
111111111111111111111111111111111111
