SO                                            ./asset/Water_1.xpm

WE                                        ./asset/Water_6.xpm

EA  ./asset/Water_11.xpm





NO  ./asset/Water_10.xpm
C   0,+0000000159,247
F   24,100,171



1111
1W11
1111