SO                                         ./asset/Water_1.xpm

WE                                        ./asset/Water_6.xpm

EA ./asset/Water_11.xpm

NO ./asset/Water_10.xpm
C 0,+59,255
F 24,100,171


                  111
            111111101                                                  111
            1     111                                                  101
            1                                                          111
        111111111111111111111
     1111110000000000000000111111111
        101111111000000000111111111111111         1
       1111111111100000000000000111111111
                 11111111111111111
         1111111111111111111111111





