SO                                         ./asset/Water_1.xpm

WE                                        ./asset/Water_6.xpm

EA ./asset/Water_11.xpm

NO ./asset/Water_10.xpm
C 0,+59,255
F 24,100,171








        11111111111111111111111111111111
        10000000000000000000000000000001
        11111111111111111111111111111111
        1000000011       111110000000001
        1000000011       1  110000000001
        1000W100011   11111  11000000011
        100000011   1 1  1 110000000011
        1000000011   1 1 1  110000000011
        1000000011 1 11111  110000000011
        1000000011         1111000000001
        11111111111111111111111111111111
        11111111111111111111111111111111
        11111111111111111111111111111111
                                          
                                       
        11111111111111111111111111111111
        100000000000000000000000000000011111111111111111111
        111111111111111111111111111111111111111111111111111
        1000000011 111111111110000000001
        1000000011 1        110000000001
        1000000011 1 111111 110000000001111111111111111111
        1001110011 1 1    1 110000000001111111111111111111
        1001 10011 1 1 11 1 110000000001
        1001110011 1 1  1 1 110000000001111111111111111111
        1000000011 1 1111 1 110000000001111111111111111111
        1000000011 1      1 110001110011
        1000000011 11111111 110001 10011
        1000000011         1111001110001111111111111111111
        11111111111111111111111111111111110101111111111111
        1111        11111111111111111   111111111
        1111111111111111111111111111111

